12
8
4 1 1 1 1 1 1 1
4 1 0 0 8 0 0 1
4 1 0 0 9 0 0 1
4 1 1 2 1 3 1 1
4 1 0 0 1 0 0 1
4 1 0 2 1 3 0 1
4 1 0 0 1 0 0 1
1 1 0 1 1 0 1 1
1 0 0 8 0 8 0 1
1 0 0 0 8 0 0 1
1 1 1 0 0 0 1 1
4 4 1 1 1 1 4 4