9
7
1 1 1 1 1 4 4
1 0 0 0 1 1 1
1 3 0 3 0 0 1
1 0 0 0 1 0 1
1 1 0 1 0 0 1
4 1 9 2 2 0 1
4 1 0 0 0 0 1
4 1 0 0 1 1 1
4 1 1 1 1 4 4
